1111111111111111111111111111111111
100000000000000C00000C00000000EC01
1000010100100000101001000000010101
1010010010101010001001000000010101
1P0000000C00C0000000000000000000C1
1111111111111111111111111111111111