1111111111111111111111
10000C000000001N100001
1P01111111100C00011101
100C000000000000000001
1001111110011111111C01
10000010000000000N0001
100010C00N0001000100E1
1111111111111111111111