11111111111111111111111111111111111
1000P00000001N00000000000N000000001
10100000000000010001111110001000001
10100000N0000001000011111000100C001
1010C000111111111110000000001000001
101000001100C011111000000C001000001
10100000110110111110000000001000001
1C1000001101E0000000N000000N00000C1
11111111111111111111111111111111111
