111111111111111111111111111111111111111111111
1CPE11111111111111111111111111111111111111111
111111111111111111111111111111111111111111111